1111111111111111111111111111111111
1000000000000000000000000000000001
10P00000000000000000000000C0000001
1000000000000000I00000000000000001
10000C0000I00000000000000000000001
1000000000000000000000000000000001
1000000000000000C00000000000000001
100000000000000000C000000I00000001
100000000C00000I0000C0000000000001
1000000000I00000000000000000000001
1000000000I0000I000000000000000001
10000000000C0000000000000000000001
1000C00000000000000C00000000000001
10000000000000000C0000000000000001
1000000000I00000000000000000000001
100000000C0000000000000000000C0001
1000000000000000000000000000000001
1000000C000C00000000C0000000000E01
1000000000000000000000000000000001
1111111111111111111111111111111111