1111111111111111111111111111111111
1E0000000000000C000I0C0000000000I1
10100101001000001010010I0000010101
1010I1001010101I001001000I00010101
1P00000I0C00C00000000000000I0000C1
1111111111111111111111111111111111