111111111111111
100000I0000C001
100C0000P0I0001
11I1110I0011111
1E00000C0011111
111111111111111