111111111
10P000C01
100000001
10C000E01
100000001
111111111