11111111111111111111111111
111000000000C0000000000011
11101111111111111111111011
11P0I1III1III1IIII1I1I0E11
11I111I111I1I1I1111I1I1I11
11III1III1III1I1II1I1I1I11
1111I1I111II11I11I1I1I1I11
11III1III1I1I1I1II1I1III11
11111111111111111111111111
1I111111111111111111111I11
11111111111111111111111111